################
##......#......#
##......#...#..#
#.......#####..#
#..............#
#..............#
#..T...........#
#....X.........#
################
