##########
#........#
#.....|..#
#......r.#
#........#
#........#
#..T.....#
#....X...#
##########
